7
Missile
Planet
Carrier
_Kamikaze
Artillery
ShieldPowerUp
11
10
1 2 5 0 1 0 0 4 1 1 
1 0 0 1 1 0 0 4 0 1 
1 0 0 1 3 0 0 4 0 0 
0 2 5 1 1 0 0 4 0 0 
1 0 0 6 1 1 5 4 0 1 
1 0 0 0 1 1 5 4 1 1 
1 0 0 1 1 0 0 4 0 1 
0 2 5 1 3 0 0 4 0 0 
1 0 0 1 1 0 0 4 0 0 
1 0 0 0 1 0 0 4 0 1 
1 2 5 0 1 0 0 4 1 1 
