7
Missile
Planet
Carrier
_Kamikaze
Artillery
ShieldPowerUp
11
20
2 0 1 0 3 0 1 0 5 0 1 0 2 2 1 0 3 0 1 0 
0 1 0 1 0 1 6 1 0 1 0 1 2 1 0 1 5 1 0 1 
1 0 0 0 1 4 6 0 1 0 3 0 1 0 0 0 1 0 5 0 
0 1 0 1 0 1 6 1 0 1 0 1 0 1 0 1 5 1 0 1 
2 0 1 0 3 0 1 0 5 0 1 0 2 2 1 0 3 0 1 0 
0 1 0 1 0 1 6 1 0 1 0 1 2 1 0 1 5 1 0 1 
1 0 0 0 1 4 6 0 1 0 3 0 1 0 0 0 1 0 5 0 
0 1 0 1 0 1 6 1 0 1 0 1 0 1 0 1 5 1 0 1 
2 0 1 0 3 0 1 0 5 0 1 0 2 2 1 0 3 0 1 0 
0 1 0 1 0 1 4 1 0 1 0 1 2 1 0 1 5 1 0 1 
1 0 0 0 1 4 0 0 1 0 1 0 1 0 0 0 1 0 5 0 
