7
Missile
Planet
Carrier
_Kamikaze
Artillery
ShieldPowerUp
11
20
0 0 0 0 0 0 1 2 5 0 0 4 0 0 0 0 5 0 0 0 
0 0 0 0 0 1 0 1 5 0 0 4 0 0 0 5 0 0 0 0 
0 0 0 0 1 0 1 1 5 0 0 4 2 0 5 0 0 0 1 2 
0 0 0 1 0 1 1 2 3 0 0 4 2 3 0 0 0 1 2 5 
0 6 0 0 1 1 2 3 0 0 0 1 0 2 3 0 0 0 1 2 
6 0 0 1 1 0 0 0 0 1 1 0 0 0 2 0 0 1 2 5 
0 6 0 0 1 1 2 3 0 0 0 1 0 2 3 0 0 0 1 2 
0 0 0 1 0 1 1 2 3 0 0 4 2 3 0 0 0 1 2 5 
0 0 0 0 1 0 1 1 5 0 0 4 2 0 5 0 0 0 1 2 
0 0 0 0 0 1 0 1 5 0 0 4 0 0 0 5 0 0 0 0 
0 0 0 0 0 0 1 2 5 0 0 4 0 0 0 0 5 0 0 0 
