7
Missile
Planet
Carrier
_Kamikaze
Artillery
ShieldPowerUp
11
15
0 0 0 0 0 0 4 0 0 0 0 4 0 0 0 
0 0 0 0 0 0 4 0 1 0 0 4 0 0 0 
0 0 0 0 0 0 4 1 0 0 0 4 0 0 0 
0 0 0 0 1 1 1 0 0 0 0 4 0 0 0 
6 0 0 1 2 3 5 1 0 0 0 4 0 3 5 
6 0 1 2 3 0 0 5 1 0 0 4 0 0 0 
6 0 0 1 2 3 5 1 0 0 0 4 0 3 5 
0 0 0 0 1 1 1 0 0 0 0 4 0 0 0 
0 0 0 0 0 0 4 1 0 0 0 4 0 0 0 
0 0 0 0 0 0 4 0 1 0 0 4 0 0 0 
0 0 0 0 0 0 4 0 0 0 0 4 0 0 0 
