7
Missile
Planet
Carrier
Kamikaze
Artillery
ShieldPowerUp
7
45
0 1 0 0 0 0 0 4 1 1 1 1 0 0 0 2 0 0 1 0 0 4 0 4 2 3 0 0 0 0 0 0 0 0 1 0 1 0 0 0 2 3 5 0 0 
0 4 1 0 1 1 1 1 0 0 0 4 0 0 0 1 2 0 4 3 0 0 4 0 0 2 3 0 0 0 2 5 0 1 5 0 1 3 0 0 2 3 5 0 0 
4 1 0 0 0 0 0 4 1 1 1 1 0 6 0 2 0 0 1 0 0 4 0 4 2 3 0 0 6 0 0 0 0 1 5 0 1 5 0 0 2 3 5 0 0 
1 0 0 0 1 1 1 1 0 0 0 4 0 6 0 1 2 0 4 3 0 0 4 0 0 2 3 0 6 0 2 5 0 4 4 0 1 3 0 0 2 3 5 0 1 
4 1 0 0 0 0 0 4 1 1 1 1 0 6 0 2 0 0 1 0 0 4 0 4 2 3 0 0 6 0 0 0 0 1 5 0 1 5 0 0 2 3 5 0 0 
0 4 1 0 1 1 1 1 0 0 0 4 0 0 0 1 2 0 4 3 0 0 4 0 0 2 3 0 0 0 2 5 0 1 5 0 1 3 0 0 2 3 5 0 0 
0 1 0 0 0 0 0 4 1 1 1 1 0 0 0 2 0 0 1 0 0 4 0 4 2 3 0 0 0 0 0 0 0 0 1 0 1 0 0 0 2 3 5 0 0 
