7
Missile
Planet
Carrier
Kamikaze
Artillery
ShieldPowerUp
7
20
0 0 0 0 4 0 0 1 0 0 0 0 0 1 0 0 0 2 0 0 
0 0 0 4 1 0 0 1 0 0 0 4 0 1 0 0 0 2 0 0 
6 0 0 1 0 0 6 1 2 0 0 4 6 2 3 0 6 3 5 0 
0 6 0 0 1 0 6 2 0 0 2 3 6 1 5 0 6 0 2 0 
6 0 0 1 0 0 6 1 2 0 0 4 6 2 3 0 6 3 5 0 
0 0 0 4 1 0 0 1 0 0 0 4 0 1 0 0 0 2 0 0 
0 0 0 0 4 0 0 1 0 0 0 0 0 1 0 0 0 2 0 0 
